;erim04.xsb
#########
#  @##  #
# $$  ..##
#  $$#.. #
# $$ #.. #
#  # #####
##   #
 #####
Title: erim04-first collection
Author: Erim SEVER from TURKEY

