;erim105.xsb
##########
#   ##   #
# $..* $@#
#    #####
##   #
 #####
Title: erim105-second collection
Author: Erim SEVER from TURKEY

