;erim151.xsb
   ####
####  #
#  #  #
#  . .#
#$$$$$#
#. . .#
#  # @#
#  ####
####
Title: erim151-second collection
Author: Erim SEVER from TURKEY

