;erim30kid.xsb
######
# .  #
#$$$ #
#. .@#
######
Title: erim30(for kids)-first collection
Author: Erim SEVER from TURKEY

