;erim257.xsb
    #####
#####   #
#   $ $ #
# #.#. ##
# $.*.$#
### #  #
  #   @#
  ######
Title: erim257-fifth collection
Author: Erim SEVER from TURKEY