;erim201.xsb
#####
#   #
# $ ##
#  . #
###* #
 # .@#
 # $##
 #  #
 ####
Title: erim201-fourth collection
Author: Erim SEVER from TURKEY