;erim121.xsb
  ####
 ##  ##
##    ##
#   $  #
#.**$*.#
##    ##
 ## @##
  ####
Title: erim121-second collection
Author: Erim SEVER from TURKEY

