;erim65.xsb
 ####
 #. ###
##*$  #
# .$ @#
# * ###
#   #
#####
Title: erim65-second collection
Author: Erim SEVER from TURKEY

