;erim188.xsb
 ####
 #  #
 #  #
 #$ #
## .#
# $.#
#  @#
#####
Title: erim188-fourth collection
Author: Erim SEVER from TURKEY