;erim101.xsb
 ########
 #      #
 # $**. #
 # *  * #
 # *  *##
 # *  * #
 # *# * #
 # .**$ #
 #     @#
 ########
Title: erim101-second collection
Author: Erim SEVER from TURKEY

