;erim168.xsb
  ####
###  ####
#    #  #
#  * *  #
###***  #
  #@*   #
  #######
Title: erim168-StartWithEndPosition-second collection
Author: Erim SEVER from TURKEY

