;erim01.xsb
#####
#   #####
# $     #  #####
# $# @# ####. .###
# $ $## #     ...#
###$    #  ## ...#
  #    $    ## ###
  ####  ##$$   #
     #####  ####
         #  #
         ####
Title: erim01-first collection
Author: Erim SEVER from TURKEY