;erim259.xsb
    #####
#####   #
# $     #
# $.#. ##
# .$.$ #
###.$.$#
  #   @#
  ######
Title: erim259-fifth collection
Author: Erim SEVER from TURKEY