;erim119.xsb
  ####
 ##  ##
##  $ ##
# .... #
# *$$$ #
##    ##
 ## @##
  ####
Title: erim119-second collection
Author: Erim SEVER from TURKEY

