;erim214.xsb
 #####
 #   ##
 #  $ ##
####.  #
#  $** #
# @ .. #
####$ ##
   #  #
   ####
Title: erim214-fourth collection
Author: Erim SEVER from TURKEY