;erim185.xsb
  ######
  #    #
###  $ ###
#  $*#*  #
# ##..*  #
#  #.+## #
## ##*$  #
 #  $  ###
 ##    #
  ######
Title: erim185-third collection
Author: Erim SEVER from TURKEY