;erim147.xsb
    #####
    #   #
   ##$  ##
####  $$ #
#   *+.. #
# $*..####
##  $##
 #   #
 #####
Title: erim147-second collection
Author: Erim SEVER from TURKEY

