;erim141.xsb
#######
# .   #
# #$  #
#  $ ##
###$ ##
  # ..#
  #  @#
  #####
Title: erim141-second collection
Author: Erim SEVER from TURKEY

