;erim234.xsb
 #############
 #   #....# .#
## # $   $   #
#   # #  #.  #
# $$$$#####.##
#  $  #   ###
##  @##
 #####
Title: erim234-fourth collection
Author: Erim SEVER from TURKEY