;erim37.xsb
   #####
  ##   #
  #  # #
  # $  #
###$ # #
#..* # #
##@#   #
 #######
Title: erim37-first collection
Author: Erim SEVER from TURKEY

