;erim137.xsb
#####
#   #
#   #
#  ##
#..####
#**   #
#..$$ #
#$ #  #
# $####
#@ #
####
Title: erim137-second collection
Author: Erim SEVER from TURKEY

