;erim252.xsb
    #####
#####   #
#   ..* #
# #.*  ##
#   $###
###$ $ #
  #   @#
  ######
Title: erim252-fifth collection
Author: Erim SEVER from TURKEY