;erim258.xsb
    #####
#####   #
# $ ..$ #
#  $.* ##
#@$ *. #
###$.* #
  #    #
  ######
Title: erim258-fifth collection
Author: Erim SEVER from TURKEY