;erim12.xsb
######
#    ####
# ##    #
#  $ $  #
##$  # ##
 #   #$ #
 # $$$ @#
####.$###
#.... ..#
#   .####
######
Title: erim12-first collection
Author: Erim SEVER from TURKEY

