;erim178.xsb
#################
#   #   #   #   #
# .*# *   .*# * #
# * # * # * #** #
# *   .*# *     #
#   #   #   ## ##
#############   #
#   #   #   # * #
# *   **# *  ** #
# $*# *   **#   #
#   #   #   ## ##
## ### ### ##   #
#   #   #   # * #
# *   **# *  *$ #
# $*# *   **#  @#
#   #   #   #####
#############
Title: erim178-second collection
Author: Erim SEVER from TURKEY
