;erim179.xsb
#####      ####
#   ########  #
#             #
## $*******$  #
 # *       * ##
 # * ***** * #
 # * *. .* * #
 # * * @ * * #
 # * *. .* * #
 # * ***** * #
## *       * #
#  $*******$ ##
#             #
#  ########   #
####      #####
Title: erim179-second collection
Author: Erim SEVER from TURKEY