;erim39.xsb
########
#   * @#
# $. * ##
### *.  ###
 # *.*$$  #
 #        #
 #######  #
       ####
Title: erim39-first collection
Author: Erim SEVER from TURKEY

