;erim32kid.xsb
######
#... #
# #$ #
# $  #
# $ ##
#@ ##
####
Title: erim32(for kids)-first collection
Author: Erim SEVER from TURKEY

