;erim90.xsb
   ####
#### .#
#.    #
# $ *$##
##$* $ #
 #    .#
 #.@####
 ####
Title: erim90-second collection
Author: Erim SEVER from TURKEY

