;erim216.xsb
#####
#.. #
# $ ###
#. #  #
#.$#$ #
## $  #
 #   @#
 #  ###
 ####
Title: erim216-fourth collection
Author: Erim SEVER from TURKEY