;erim74.xsb
   ####
####  #
#    $#
# ..* ##
##.*   #
 #$  $@#
 #  ####
 ####
Title: erim74-second collection
Author: Erim SEVER from TURKEY

