;erim139.xsb
   #####
   #   #
   # $ #
####*$ ####
#   ...*  #
# $$.*.$$ #
#  *...   #
#### $*####
   # $ #
   #  @#
   #####
Title: erim139-second collection
Author: Erim SEVER from TURKEY

