;erim192.xsb
 #####
 #   #
##  $#
# **.#
#@  ##
#####
Title: erim192-fourth collection
Author: Erim SEVER from TURKEY