;erim71.xsb
   ####
####  #
# $  $#
#   ..##
##..   #
 # $ $ #
 # @####
 ####
Title: erim71-second collection
Author: Erim SEVER from TURKEY

