;erim136.xsb
 #####
##   #
#  * ##
# $.$ #
# .$. #
# $.$ #
#@.$.##
######
Title: erim136-second collection
Author: Erim SEVER from TURKEY

