;erim25new.xsb
   ###
  ##.##
###...###
#       #
# $$ $$ #
#  # #  #
####$####
#  # # @#
# $ $ $ #
#   *   #
###...###
  ##.##
   ###
Title: erim25-first collection
Author: Erim SEVER from TURKEY

