;erim230.xsb
 ####
 #  #
##$ ###
#     ##
#  $*. #
#### .@#
   #####
Title: erim230-fourth collection
Author: Erim SEVER from TURKEY