;erim61.xsb
########
#@ ##  ##
#   #   #
# $$$$$ #
# ..... #
#########
Title: erim61-second collection
Author: Erim SEVER from TURKEY

