;erim236.xsb
    #####
#####   #
#..   # #
# $$#  ##
# #  # #
###  # #
  #   @#
  ######
Title: erim236-fifth collection
Author: Erim SEVER from TURKEY