;erim225.xsb
######
#    ##
# $.$ #
## **.#
# $.$.#
#   @ #
#######
Title: erim225-fourth collection
Author: Erim SEVER from TURKEY