;erim53.xsb
 #####
##.$.#
#  # #
# $$ #
#.  @#
######
Title: erim53-second collection
Author: Erim SEVER from TURKEY

