;erim265.xsb
    #####
#####  @#
#. ..** #
# $#. $##
#   #  #
### $$ #
  #    #
  ######
Title: erim265-fifth collection
Author: Erim SEVER from TURKEY