;erim158.xsb
 ####
 #  #
## .######
# $  $   ##
# $ $@$$. #
#   ## .. #
#.. ##  ###
#########
Title: erim158-second collection
Author: Erim SEVER from TURKEY

