;erim125.xsb
 ####
 #  ##
 # . ###
## *   ##
#  * *  #
# ***** #
#  * *  #
###  * ##
  ## $ #
   #  @#
   #####
Title: erim125-second collection
Author: Erim SEVER from TURKEY

