;erim160.xsb
     #####
     #.. #
   ###.. #
   # .  ####
#### $#    #
#..  .# $$ #
#.#$ ## $  #
#   $##  ###
#  #  ##$#
####$ $  #
   #   @##
   ######
Title: erim160-second collection
Author: Erim SEVER from TURKEY

