;erim195.xsb
   ####
####  #
#  #  #
# $.$@#
# . .##
###$ #
  #  #
  ####
Title: erim195-fourth collection
Author: Erim SEVER from TURKEY