;erim171.xsb
        ####
  #######  #
  #  #     #
  # * *** *#
###  **@#  #
#   * *#  *#
# #    * * #
#  * * *   #
####*## #  #
  # * *   ##
  #      ##
  ########
Title: erim171-StartWithEndPosition-second collection
Author: Erim SEVER from TURKEY

