;erim44.xsb
#######
#  #  #
#  #  #
# $$  #
#@ .$##
###..#
  ####
Title: erim44-second collection
Author: Erim SEVER from TURKEY

