;erim238.xsb
    #####
#####  @#
#   # $ #
# $$.$ ##
# ..$. #
###. # #
  #    #
  ######
Title: erim238-fifth collection
Author: Erim SEVER from TURKEY