;erim112.xsb
  ####
###  ###
#.* $  #
#*.* $ ##
#.*.$ $ #
#*.* $ @#
#.* $ ###
#######
Title: erim112-second collection
Author: Erim SEVER from TURKEY

