;erim52.xsb
     ####
 #####@ #
 #  #  $#
##$ $ $.##
#   ##$..#
#      ..#
##########
Title: erim52-second collection
Author: Erim SEVER from TURKEY

