;erim187.xsb
 ####
 # @#
 #.$##
##*  #
#    #
#   ##
#####
Title: erim187-fourth collection
Author: Erim SEVER from TURKEY