;erim19.xsb
 #######
 #     #
## .*$ #
#  *@* #
#  $*. #
##    ##
 ######
Title: erim19-first collection
Author: Erim SEVER from TURKEY

