;erim235.xsb
#####  ####
#   ####  #
#  $ $    #
##*$.#### ##
 # #....#  #
 # $.#* #  #
 #   $  $  #
 ##### @####
     ####
Title: erim235-fourth collection
Author: Erim SEVER from TURKEY