;erim126.xsb
    #####
    #   #
#####$  #
#@$..$* #
## $.  ##
 ###  .#
   #####
Title: erim126-second collection
Author: Erim SEVER from TURKEY

