;erim132.xsb
 #####
##   ###
# .$.  #
# $ $ @#
# .$.###
######
Title: erim132-second collection
Author: Erim SEVER from TURKEY

