;erim94.xsb
#######
#     #
# $$$ #
# *..##
# $$*#
# $ .#
# *..#
# $$*#
#@...#
######
Title: erim94-ForKids-second collection
Author: Erim SEVER from TURKEY

