;erim249.xsb
    #####
#####   #
#   #$$@#
# $ #. ##
#  .*.$#
###.#  #
  #    #
  ######
Title: erim249-fifth collection
Author: Erim SEVER from TURKEY