;erim220.xsb
 #####
##   #
#  # #
# $$ ###
# *.*$ #
# .#.  #
#   @###
######
Title: erim220-fourth collection
Author: Erim SEVER from TURKEY