;erim266.xsb
    #####
#####   #
#  .$ $ #
# $.*. ##
#@$.*. #
###.$ $#
  #.$  #
  ######
Title: erim266-fifth collection
Author: Erim SEVER from TURKEY