;erim191.xsb
  #####
###.  #
# $$$ #
#..  @#
#  ####
####
Title: erim191-fourth collection
Author: Erim SEVER from TURKEY