;erim251.xsb
    #####
#####   #
##      #
# .$.$.##
# $.*.$#
###$.$ #
  #   @#
  ######
Title: erim251-fifth collection
Author: Erim SEVER from TURKEY