;erim35.xsb
####
#  #############
#        $@....#
#  #######$#####
## #.. ..# #
 # #*$ $ $ #
 # $  $  # #
## ###   # ##
# $#######  #
#           #
##########  #
         ####
Title: erim35-first collection
Author: Erim SEVER from TURKEY

