;erim130.xsb
#######
#    .#
#$$$$ ##
#....$@#
########
Title: erim130-second collection
Author: Erim SEVER from TURKEY

