;erim218.xsb
######
#    #
#  $ ##
##$*  #
 # *# #
 # ..@#
 ######
Title: erim218-fourth collection
Author: Erim SEVER from TURKEY