;erim68.xsb
  ####
  #  #
###  ##
#  *$ #
# #.# #
#    @#
#######
Title: erim68-second collection
Author: Erim SEVER from TURKEY

