;erim134.xsb
  ####
###  #
# $ $####
# . .   #
# $.$. @#
#########
Title: erim134-second collection
Author: Erim SEVER from TURKEY

