;erim250.xsb
    #####
#####   #
#    $  #
#.*.**.##
# $  $ #
### ## #
  #   @#
  ######
Title: erim250-fifth collection
Author: Erim SEVER from TURKEY