;erim146.xsb
 ####
 #  ###
##    #
#  ** #
#  *@##
##  ##
 ####
Title: erim146-StartWithEndPosition-second collection
Author: Erim SEVER from TURKEY

