;erim165.xsb
     ##########
     #    #   ####
     #   *   *#  #
     ## **##     ##
  #####  * ###**  #
  #     #* #      #
### * * *@* * * ###
#      # *#     #
#  **### *  #####
##     ##** ##
 #  #*   *   #
 ####   #    #
    ##########
Title: erim165-StartWithEndPosition-second collection
Author: Erim SEVER from TURKEY

