;erim80.xsb
     ####
     #  #
######  #
#     *.#
#  $$$*.#
###.*@*.###
  #.*$$$  #
  #.*     #
  #  ######
  #  #
  ####
Title: erim80-second collection
Author: Erim SEVER from TURKEY

