;erim113.xsb
########
#   #  ##
# $  *  #
#$ $* * #
#.$..*. #
# # # # #
#.*  $. #
#* *$ $ #
# *..$@##
########
Title: erim113-second collection
Author: Erim SEVER from TURKEY

