;erim159.xsb
 ######
## @  ##
# $##  #
#  ##$ #
#.$#. .#
#. . ###
#.$# ###
#  $ $ #
#. $   #
########
Title: erim159-second collection
Author: Erim SEVER from TURKEY

