;erim197.xsb
  #####
  # @ ##
###$#* #
#  .   #
#  .#$ #
###   ##
  #####
Title: erim197-fourth collection
Author: Erim SEVER from TURKEY