;erim154.xsb
 ####
 #  ####
 # ... #
##$.#  #
#  ##  #
# $$ $##
#    @#
#######
Title: erim154-second collection
Author: Erim SEVER from TURKEY

