;erim55.xsb
#####
#. .#
# $ #
# * #
# $ #
## @#
 ####
Title: erim55-second collection
Author: Erim SEVER from TURKEY

