;erim63.xsb
    ####
    #  ##
 #### $ #####
 #  # # ##  ##
 #  $  $+....#
 #  # ##$##.##
 ## # ## #.. #
 #  #  # #.. #
 #    $#  #. #
##  ##    ####
# $$ #  $ #
#  $  $ $##
#    #   #
##########
Title: erim63-second collection
Author: Erim SEVER from TURKEY

