;erim156.xsb
    ######
    #    #
    # $ $##
  ###$    #
###  **.*$####
# $$ .....$  #
#   *..*** $ #
# $ ***..*   #
#  $..... $$ #
####$*.**  ###
   #    $###
   ##$ $ #
    #   @#
    ######
Title: erim156-second collection
Author: Erim SEVER from TURKEY

