;erim211.xsb
######
#    #
# @$.#
##$*.#
 # $.#
 #   #
 #####
Title: erim211-fourth collection
Author: Erim SEVER from TURKEY