;erim60.xsb
    #####
#####   #
#   #   #
# $$$$$ #
#@..... #
#########
Title: erim60-second collection
Author: Erim SEVER from TURKEY

