;erim48.xsb
  ####
  #  #
###  ###
#  $*  #
#  *. @#
###  ###
  #  #
  ####
Title: erim48-second collection
Author: Erim SEVER from TURKEY

