;erim246.xsb
    #####
######  #
# $  ..##
# $#*$.##
#  ..#.#
###$ $$#
  #   @#
  ######
Title: erim246-fifth collection
Author: Erim SEVER from TURKEY