;erim58.xsb
 #####     #####
 #   #     #   #
 # $ ####### $ ##
## $$ $ # .**.. #
#   $  $   $.   #
# $     # $ .#*##
###@ ###### ...#
  ####    #..###
          ####
Title: erim58-second collection
Author: Erim SEVER from TURKEY

