;erim10.xsb
  ######
  #    #
###$ $ ####
#   $   $ ##
# $ # $ .* #
###  #  #. #
  #  $ #..@#
  #  $##...#
  ## $ #####
   #  .#
   ###.#
     ###
Title: erim10-first collection
Author: Erim SEVER from TURKEY

