;erim245.xsb
    #####
#####   #
#@    $ #
#  $**$##
# $.#..#
###.#  #
  # .$ #
  ######
Title: erim245-fifth collection
Author: Erim SEVER from TURKEY