;erim66.xsb
######
#    ###
# $*.$ #
# $ .. #
##  @###
 #####
Title: erim66-second collection
Author: Erim SEVER from TURKEY

