;erim186.xsb
 ####
##  #
#   ###
#  *$ #
# #.  #
#  @###
#####
Title: erim186-fourth collection
Author: Erim SEVER from TURKEY