;erim128.xsb
######
#    #
#  $ #
#$$$ ##
#...*+#
#######
Title: erim128-second collection
Author: Erim SEVER from TURKEY

