;erim202.xsb
 ####
##  ##
#    ##
# *+$ #
## *  #
 #   ##
 #####
Title: erim202-fourth collection
Author: Erim SEVER from TURKEY