;erim28.xsb
  #######
 ##...  #
 #  #$# #
 #    # #
## ##$# #
#    $  #
#@  #  ##
########
Title: erim28-first collection
Author: Erim SEVER from TURKEY

