;erim15.xsb
          #####
          #...#
          #.. #
######### #...#
#.      # #  ##
#.  $ $ # #  #
## $##### #  #
 #  ####  ## ##
 # $$  #####  #
 #            #
 # ########$  #
 # ###### # $ #
 #   $  # #$  #
 #   $  # #   #
 ##### @# #####
     ####
Title: erim15-first collection
Author: Erim SEVER from TURKEY

