;erim264.xsb
    #####
#####   #
##    $ #
# $$# ###
#   #..#
### $..#
  #   @#
  ######
Title: erim264-fifth collection
Author: Erim SEVER from TURKEY