;erim123.xsb
  ######
 ##    ##
## .  . ##
#  * $.  #
# $*$$*$ #
## .  .@##
 ########
Title: erim123-second collection
Author: Erim SEVER from TURKEY

