;erim05.xsb
####
#..###
#...@######
#..$      #
###$ ###  #
### $# $ ##
#    $   #
# $$ ##  #
#   ###  #
##### ####
Title: erim05-first collection
Author: Erim SEVER from TURKEY

