;erim261.xsb
    #####
#####   #
#       #
#  * $.##
##.**#$#
###$.# #
  #   @#
  ######
Title: erim261-fifth collection
Author: Erim SEVER from TURKEY