;erim157.xsb
  ########
  #  ## .#
###$ ##$.###
#    $     #
# $  @$  $ #
#.$##.$##$.#
#. ##..## .#
############
Title: erim157-second collection
Author: Erim SEVER from TURKEY

