;erim83.xsb
   ####
####  ##
#      ##
#. ***  #
## $@*  #
 #  *  ##
 #######
Title: erim83-second collection
Author: Erim SEVER from TURKEY

