;erim239.xsb
    #####
#####   #
# $     #
# $###*##
#  .#..#
### $  #
  #   @#
  ######
Title: erim239-fifth collection
Author: Erim SEVER from TURKEY