;erim254.xsb
    #####
#####   #
# .$. . #
# # # *##
#  *.$ #
### $ $#
  #   @#
  ######
Title: erim254-fifth collection
Author: Erim SEVER from TURKEY