;erim142.xsb
#############
#  .  .  ##@#
# .* * * ##$##
## ##.# ###..#
 # # $#   $ .#
 # $  #$$ #  #
 #      $ ####
 #   ######
 #####
Title: erim142-second collection
Author: Erim SEVER from TURKEY

