;erim196.xsb
#######
#     ##
#@$***.#
###    #
  #   ##
  #####
Title: erim196-fourth collection
Author: Erim SEVER from TURKEY