;erim229.xsb
#####
#   ##
# .  ####
#.$. $  #
# .## # #
#####$$ #
    #  @#
    #####
Title: erim229-fourth collection
Author: Erim SEVER from TURKEY