;erim31kid.xsb
 #########
##  $@...#
#  $$#####
#    #
##   #
 #####
Title: erim31(for kids)-first collection
Author: Erim SEVER from TURKEY

