;erim22.xsb
##########
#   ##   #
#      $ #
### ###$##
  # # # #
 ## ##  ####
 #       $ #
 # $## ### #
 #  #    # #
 ####  # # #
   #.# ##@ #
   #*.  ####
   #..  #
   #    #
   ######
Title: erim22-first collection
Author: Erim SEVER from TURKEY

