;erim177.xsb
##################
#..  #  *  #     #
#.*. #  $  #  $  #
#.#  #$ #$ #$ #  #
#.#  $  #  $  # ##
#.#  *  #  *  #  #
#*#############  #
#.#  *  #  *  #  #
#.#  $  #  $  # ##
#.#  #$ #$ #$ #  #
#.*. #  $  #  $  #
#..@ #  *  #     #
##################
Title: erim177-second collection
Author: Erim SEVER from TURKEY

