;erim115.xsb
  ####
 ##  #
##   ###
#  .*  #
# $ *  #
###   ##
  #@ ##
  ####
Title: erim115-second collection
Author: Erim SEVER from TURKEY

