;erim27.xsb
  #######
 ##... .#
 # $#.# #
 #$@  $ #
## ##$# #
# $     #
#   #  ##
########
Title: erim27-first collection
Author: Erim SEVER from TURKEY

