;erim203.xsb
 #####
##   #
# $# #
#  ..#
# $* #
###@ #
  ####
Title: erim203-fourth collection
Author: Erim SEVER from TURKEY