;erim217.xsb
 ####
 #  ######
 #  ##   #
 # $  $  #
 ##.##.###
###.##.##
#  $  $ #
#   ##  #
###### @#
     ####
Title: erim217-fourth collection
Author: Erim SEVER from TURKEY