;erim143.xsb
 ######
##    #
# $$$ #
#   $ ##
#   *. #
####..+#
   #####
Title: erim143-second collection
Author: Erim SEVER from TURKEY

