;erim129.xsb
#######
#     #
# $ $ #
#$$$* ##
#....*+#
########
Title: erim129-second collection
Author: Erim SEVER from TURKEY

