;erim16.xsb
    ####
   ##..#
  ##  $#
 ##  $ #
##  $ ##
# $  ##
#  $##
#  $ ##
##  $ ##
 ##  $@##
  ##  $ ##
   ##  $ ####
    ##  $ ..###
     ##.......#
      #########
Title: erim16-first collection
Author: Erim SEVER from TURKEY

