;erim114.xsb
  ####
###  #
#    ###
# $   @###
### $  $ #
  ###$...#
    # .###
    ####
Title: erim114-second collection
Author: Erim SEVER from TURKEY

