;erim219.xsb
       ###
    ####.#
##### $..#
#   #  $.#
# $$##  ##
#      ##
##### @#
    ####
Title: erim219-fourth collection
Author: Erim SEVER from TURKEY