;erim204.xsb
######
#  *.##
# $**.###
#   .*  #
### $#$ #
  ##  @ #
  #######
Title: erim204-fourth collection
Author: Erim SEVER from TURKEY