;erim255.xsb
    #####
#####   #
#       #
# $ $ ###
# $ #..#
###$ ..#
  #   @#
  ######
Title: erim255-fifth collection
Author: Erim SEVER from TURKEY