;erim99.xsb
#####
#@$.#
# $.#
##$.#
#   #
#   #
#####
Title: erim99-ForKids-second collection
Author: Erim SEVER from TURKEY

