;erim14new.xsb
 ######
 #    #
##  $$##
#  #$  #
# $  #.##
#  $##..###
##   ...$ #
 ####@*   #
    #######
Title: erim14new-second collection
Author: Erim SEVER from TURKEY

