;erim64.xsb
  #####
  #   #
### $ ###
#   $   ##
# .**.$*.#
#   $    #
### * ####
  # . #
  #  @#
  #####
Title: erim64-second collection
Author: Erim SEVER from TURKEY

