;erim144.xsb
####   #####
#  #####   #
#          #
#  # ## # ##
## #    # #
 #     ## #
## ##. ## #
#      ##$#
#   ##   @#
###########
Title: erim144-second collection
Author: Erim SEVER from TURKEY

