;erim226.xsb
  ######
  #    #
### #  #
#  *** #
#  *+$ #
### #  #
  #   ##
  #####
Title: erim226-fourth collection
Author: Erim SEVER from TURKEY