;erim110.xsb
  ####
  # @#
###. #
#  $$#
#   .#
######
Title: erim110-ILoveVeryLittleKidsToo-second collection
Author: Erim SEVER from TURKEY

