;erim148.xsb
    #####
    #   #
   ##$  ##
   #  $$ #
####$... #
# ...+####
# $$  #
##  $##
 #   #
 #####
Title: erim148-second collection
Author: Erim SEVER from TURKEY

