;erim263.xsb
    #####
#####   #
# *.... #
# $*#* ##
#@$ $  #
### $  #
  #    #
  ######
Title: erim263-fifth collection
Author: Erim SEVER from TURKEY