;erim42.xsb
#####
#...##
#.$$ ###
#@* $ .#
### $  #
  #  $ #
  ###  #
    ####
Title: erim42-first collection
Author: Erim SEVER from TURKEY

