;erim118.xsb
########
#.# @#.#
# $  $ #
# $..$ #
#  #  ##
#######
Title: erim118-ForKids-second collection
Author: Erim SEVER from TURKEY

