;erim56.xsb
######
#.  .#
# $$$#
#$ * #
#. @.#
######
Title: erim56-second collection
Author: Erim SEVER from TURKEY

