;erim26new.xsb
  ####
###  #
# .$.###
# $@$  #
##.$.  #
 #  ####
 ##  #
  #  #
  #  #
  ####
Title: erim26-first collection
Author: Erim SEVER from TURKEY

