;erim96.xsb
####   #####
#  #####   #
# $$     $ #
#  # ## # ##
## #... # #
 #  .*.## #
##$##.. # #
# $   $ #$#
#   ##   @#
###########
Title: erim96-ILostThisLevelAndThxStephanieFabianForRescue-second collection
Author: Erim SEVER from TURKEY

