;erim233.xsb
 #####
##   #
#    #
#  $ ###
# $$$$.#
##   ..#
 ####.+#
    ####
Title: erim233-fourth collection
Author: Erim SEVER from TURKEY