;erim206.xsb
 #####
 #   ##
 # $  #
 #$## #
## ## #
# $ . #
#@.. ##
######
Title: erim206-fourth collection
Author: Erim SEVER from TURKEY