;erim228.xsb
######
#    #
#.$  #
#.$######
#.$ #   #
#   @ $.#
##  ##$.#
 #### $.#
    #   #
    #####
Title: erim228-fourth collection
Author: Erim SEVER from TURKEY