;erim106.xsb
###########
#   #     #
# *..* $ @#
#  $ ######
##   #
 #####
Title: erim106-second collection
Author: Erim SEVER from TURKEY

