;erim270.xsb
    #####
#####   #
#.....$ #
# ## # ##
# $  $ #
###$ $ #
  #   @#
  ######
Title: erim270-fifth collection
Author: Erim SEVER from TURKEY