;erim198.xsb
######
#    #
#.$  #
#.$###
#.$ #
#   #
## @#
 ####
Title: erim198-fourth collection
Author: Erim SEVER from TURKEY