;erim172.xsb
        ####
    #####  #
    #      #
    # ### *##
 #### # * * ##
 #    #  * *@#
 # #  # # * ##
 # ##      ##
## ### #####
# **  * #
#       #
#  ######
####
Title: erim172-StartWithEndPosition-second collection
Author: Erim SEVER from TURKEY

