;erim237.xsb
    #####
#####  ##
#@  #$. #
# #* . ##
# .$ $ #
#### # #
  #    #
  ######
Title: erim237-fifth collection
Author: Erim SEVER from TURKEY