;erim81.xsb
   ####
####  ###
#       #
#  ***  #
## *   ##
 # ***  #
 # *@*  #
 #  *  ##
 #######
Title: erim81-StartWithEndPosition-second collection
Author: Erim SEVER from TURKEY

