;erim140.xsb
##########
#.     ..#
#*##  .. #
# ##### ##
#    @# #
# #$$$# #
#     $ #
##  # $ #
 ####   #
    #####
Title: erim140-second collection
Author: Erim SEVER from TURKEY

