;erim46.xsb
######
# ...###
# $$*  #
#@$ *  #
### ** #
  #    #
  ######
Title: erim46-second collection
Author: Erim SEVER from TURKEY

