;erim111.xsb
   ####
   #  #
####  #
# $ $ #
#@$   ####
### $ $  #
  ##  ...#
   ## ..##
    #####
Title: erim111-second collection
Author: Erim SEVER from TURKEY

