;erim241.xsb
    #####
#####   #
#       #
# $#$*$##
# .....#
###$$# #
  #   @#
  ######
Title: erim241-fifth collection
Author: Erim SEVER from TURKEY