;erim117.xsb
#######
#  #@ ##
# $  $ #
#.*  *.#
########
Title: erim117-ForKids-second collection
Author: Erim SEVER from TURKEY

