;erim208.xsb
  ####
  #  ###
###    #
# **.$ #
# $.** #
#    @##
###  ##
  ####
Title: erim208-fourth collection
Author: Erim SEVER from TURKEY