;erim82.xsb
#####
#+$.#
# $ #
#$$ #
# $ #
#...#
#####
Title: erim82-second collection
Author: Erim SEVER from TURKEY

