;erim135.xsb
 ######
##    #
#  *  #
# $.$##
# .$. #
# $.$ #
# .$.@#
#######
Title: erim135-second collection
Author: Erim SEVER from TURKEY

