;erim76.xsb
    ####
    #  #
#####  #
##   **###
#  **@*  #
#    **  #
###  * ###
  ##   #
   #####
Title: erim76-StartWithEndPosition-second collection
Author: Erim SEVER from TURKEY

