;erim87.xsb
      ####
   #### .#
   #.  $ #
#### # * ###
#  $ $  #. #
#. $##.*  $#
##  # @ #  ##
 #$  *.##$ .#
 # .#  $ $  #
 ### *   ####
   # $  .#
   #. ####
   ####
Title: erim87-second collection
Author: Erim SEVER from TURKEY

