;erim86.xsb
      ####
   ####  #
   #     #
#### $  $###
# $ *  *.  #
#  $..$.*  #
##$ .*@*. $##
 #  *.$..$  #
 #  .* .* $ #
 ###$. $ ####
   #     #
   #  ####
   ####
Title: erim86-second collection
Author: Erim SEVER from TURKEY

