;erim29kid.xsb
######
#  ..#
#$$$ #
#.  @#
######
Title: erim29(for kids)-first collection
Author: Erim SEVER from TURKEY

