;erim109.xsb
  ####
  #  #
###  #
#  $*#
#@  .#
######
Title: erim109-ILoveKids-second collection
Author: Erim SEVER from TURKEY

