;erim262.xsb
    #####
#####   #
#    .. #
# * #. ##
# $$*$$#
###..$ #
  #   @#
  ######
Title: erim262-fifth collection
Author: Erim SEVER from TURKEY