;erim269.xsb
    #####
#####   #
#.. # $ #
#...$ $##
# $.#  #
### $ $#
  #   @#
  ######
Title: erim269-fifth collection
Author: Erim SEVER from TURKEY