;erim150.xsb
 ######
 #  ..#
##$ # #
#   $ #
#  @###
#####
Title: erim150-second collection
Author: Erim SEVER from TURKEY

