;erim247.xsb
    #####
#####   #
# #.$.$ #
# $.$.$##
#  .$. #
###.$.$#
  #   @#
  ######
Title: erim247-fifth collection
Author: Erim SEVER from TURKEY