;erim222.xsb
 #####
##  @#
#    #
# $# ###
# * *$ #
##.#.  #
 #   ###
 #####
Title: erim222-fourth collection
Author: Erim SEVER from TURKEY