;erim85.xsb
   ####
####  ##
#      ##
#  ***  #
## $@*  #
 #  *. ##
 #######
Title: erim85-second collection
Author: Erim SEVER from TURKEY

