;erim200.xsb
####
#  ######
#  ##   #
# $  $  #
##.$# ###
 #.    #
 ####*$#
    #+.#
    ####
Title: erim200-fourth collection
Author: Erim SEVER from TURKEY