;erim180.xsb
##########
#   #    #
# $   ## #
# $# @## ###
# $ $## . .#
###$    ..##
  #   # .##
  ########
Title: erim180-SameErim_hex1.hsb-third collection
Author: Erim SEVER from TURKEY
