;erim43kid.xsb
 ##########
##     .*+#
#  $$######
#    #
##   #
 #####
Title: erim43-ForKids-first collection
Author: Erim SEVER from TURKEY

