;erim231.xsb
     ####
 #####  #
##   #  ##
#  $     #
# $##$$$ #
##@..... #
 #########
Title: erim231-fourth collection
Author: Erim SEVER from TURKEY