;erim23.xsb
      #######
 ######     #
 #   ##$$$$ #
 #          #
 ### ########
   # #
#### #
#  # ##
# ....#
#     #
#   #@#
#######
Title: erim23-first collection
Author: Erim SEVER from TURKEY

