;erim260.xsb
    #####
#####   #
#       #
# #**  ##
# $  *##
###.** #
  ##  @#
  ######
Title: erim260-fifth collection
Author: Erim SEVER from TURKEY