;erim108.xsb
########
#@  #  ##
#  $  $ #
# $*$*$ #
# ..... #
#########
Title: erim108-second collection
Author: Erim SEVER from TURKEY

