;erim164.xsb
   ####
   #  #
####. ###
#  $ $$@#
# . $ . #
### . ###
  ##$ #
   # .#
   ####
Title: erim164-second collection
Author: Erim SEVER from TURKEY

