;erim18.xsb
 #######
 #     #
## .** #
#  $@$ #
#  **. #
##    ##
 ######
Title: erim18-first collection
Author: Erim SEVER from TURKEY

