;erim205.xsb
   ####
  ##  #
 ##   #
 #@$  #
##$. ##
# *.##
#   #
#####
Title: erim205-fourth collection
Author: Erim SEVER from TURKEY