;erim51.xsb
    ####
##### .#
#    $*#
#   #@ #
########
Title: erim51-ForKids-second collection
Author: Erim SEVER from TURKEY

