;erim182new.xsb
     #####
    ##   #
    # $ $##
  ###$    #
###  **.*$####
# $$ .....$  #
#   *..##* $ #
# $ *##..*   #
#  $..... $$ #
####$*.**  ###
   #    $###
   ##$ $ #
    #  @##
    #####
Title: erim182new-RebuiltWithPhilippeLamat'sSolutionOfErim156-third collection
Author: Erim SEVER from TURKEY