;erim138.xsb
   #####
   #   #
   # $ #
#####$ ####
#   ...#  #
# $$...$$ #
#  #.@.   #
#### $#####
   # $ #
   #   #
   #####
Title: erim138-second collection
Author: Erim SEVER from TURKEY

