;erim175.xsb
  ######
  #    #
###  * ###
#  $**$  #
# $*..*  #
#  *.+** #
#  $**$  #
### *. ###
  #    #
  ######
Title: erim175-second collection
Author: Erim SEVER from TURKEY

