;erim215.xsb
#####
#   ####
# $$ . #
#   *# #
###   *##
  ## .*@#
   ######
Title: erim215-fourth collection
Author: Erim SEVER from TURKEY