;erim193.xsb
######
#    #
#*$$.#
#  . #
# @###
####
Title: erim193-fourth collection
Author: Erim SEVER from TURKEY