;erim08.xsb
      ####
      #  #
 ######  ###
##   ##    #
#@$  $ $#  #
#  ##$$  $ #
## $  ##.$ #
 ##   #..*##
  #####...#
      #..##
      ####
Title: erim08-first collection
Author: Erim SEVER from TURKEY

