;erim06.xsb
      ####
 ######  #
##  @#...#
#  $ #.*.#
# $####.*#
#    .#  #
# $#$##$ #
#  $ ##  #
###     $#
  ####   #
     #  ##
     ####
Title: erim06-first collection
Author: Erim SEVER from TURKEY

