;erim207.xsb
 #####
##   ##
#     ##
# $$$$ #
###...+#
  ######
Title: erim207-fourth collection
Author: Erim SEVER from TURKEY