;erim73.xsb
   ####
####  #
#    $#
# ..*.##
## *$  #
 #$   @#
 #  ####
 ####
Title: erim73-second collection
Author: Erim SEVER from TURKEY

