;erim93.xsb
########
#      #
# *** @#
# $ . ##
# $$* #
# *.. #
# $ . #
# *** #
#######
Title: erim93-second collection
Author: Erim SEVER from TURKEY

