;erim54.xsb
######
#..$ #
#.$$ #
###@ #
  ####
Title: erim54-second collection
Author: Erim SEVER from TURKEY

