;erim153.xsb
######
#....#
# $  ###
### $$ #
  #  $ #
  #   @#
  ######
Title: erim153-second collection
Author: Erim SEVER from TURKEY

