;erim124.xsb
  ########
 ##      #
##  $.$*.#
#  $**.$.#
# $*.$.  #
#  $.  ###
##  @###
 #####
Title: erim124-second collection
Author: Erim SEVER from TURKEY

