;erim33.xsb
######
#  @ #
# $  #
## #$#
# $$ #
#  $.#
#....#
######
Title: erim33-first collection
Author: Erim SEVER from TURKEY

