;erim07.xsb
########
#@     #
# * *  #
#*$***.#
# *    #
#     ##
#######
Title: erim07-first collection
Author: Erim SEVER from TURKEY

