;erim149.xsb
 ######
 #   @##
 #$$ $ #
## ##  #
# .*.*.#
#      #
####  ##
   ####
Title: erim149-second collection
Author: Erim SEVER from TURKEY

