;erim03.xsb
######
#....####
#@ $$$ .#
##  $   #
 ####$# #
    #   #
    #####
Title: erim03-first collection
Author: Erim SEVER from TURKEY

