;erim166.xsb
####
#  ####
#  #  #
#  *  #
##**  #
#@*   #
#######
Title: erim166-StartWithEndPosition-second collection
Author: Erim SEVER from TURKEY

