;erim02.xsb
      ####
    ###..#
    #  ..#
    #  $ #
###### ###
#@     ###
## # $ $ #
 # $ # # #
 #   #   #
 #########
Title: erim02-first collection
Author: Erim SEVER from TURKEY

