;erim189.xsb
    ####
    #  #
#####* #
# $    #
#   . @#
########
Title: erim189-fourth collection
Author: Erim SEVER from TURKEY