;erim183.xsb
 ####
 #  ####
 # ... #
##$.*  #
#  *# ##
# $$ $#
#    @#
#######
Title: erim183-third collection
Author: Erim SEVER from TURKEY