;erim169.xsb
    ####
#####  ####
#  *   #  #
#    * *  #
## *#***  #
 #  #@*   #
 ##########
Title: erim169-StartWithEndPosition-second collection
Author: Erim SEVER from TURKEY

