;erim174.xsb
  ######
  #    #
###  $ ###
#  .***  #
# $* .*  #
#  *.@*$ #
#  ***.  #
### $  ###
  #    #
  ######
Title: erim174-second collection
Author: Erim SEVER from TURKEY

