;erim199.xsb
########
#      ##
#@ $ *. #
#####*$*#
   #.   #
   ###  #
     ####
Title: erim199-fourth collection
Author: Erim SEVER from TURKEY