;erim17.xsb
 #######
 #     #
## .$* #
#  *@* #
#  *$. #
##    ##
 ######
Title: erim17-first collection
Author: Erim SEVER from TURKEY

