;erim78.xsb
      #######
  #####     #
 ##   #  #$ #
 #  $   ##  ###
##$$.# @ $ *  #
# *..# * * #  #
#   ## ## *.* #
###$   .##    #
  #  * .#######
  #######
Title: erim78-second collection
Author: Erim SEVER from TURKEY

