;erim242.xsb
    #####
##### . #
# $...* #
# $  # ##
#   #  #
###$ $ #
  #   @#
  ######
Title: erim242-fifth collection
Author: Erim SEVER from TURKEY