;erim34.xsb
######
#    #
# $ .#
# .$ #
#.$###
##@#
 ###
Title: erim34-first collection
Author: Erim SEVER from TURKEY

