;erim45.xsb
######
#....###
# ***  #
#@$ $  #
### $$ #
  #    #
  ######
Title: erim45-second collection
Author: Erim SEVER from TURKEY

