;erim162.xsb
     ######
  ####....#
  #...  @.#
###$ ##  .#
#    ###$##
# #  # #  #####
#.# ####$  $  #
#.#  $ #  ### #
# # $  # $### #
# # $ ##  $  .#
# $ $ #.  .*. #
#  ## #  ##$###
##### # ##   #
   #. #$ #.$ #
   #*    $ $ #
  ## ##   $  #
  # $  # #####
  #    . #
  ########
Title: erim162-second collection
Author: Erim SEVER from TURKEY

