;erim40new.xsb
########
#   .$@#
# $. * #
## #** ####
 # *.*  $ #
 #        #
 ##########
Title: erim40new-second collection
Author: Erim SEVER from TURKEY

