;erim120.xsb
  ####
 ##  ##
##....##
#  .$  #
# $$$$ #
##    ##
 ## @##
  ####
Title: erim120-second collection
Author: Erim SEVER from TURKEY

