;erim104.xsb
  #####
###   ###
# $*.*$ #
# $...$ #
#   @   #
#########
Title: erim104-ForKids-second collection
Author: Erim SEVER from TURKEY

