;erim212.xsb
    ####
    #  ##
 ####$. #
## $.*.@#
#    $  #
#   #####
#####
Title: erim212-fourth collection
Author: Erim SEVER from TURKEY