;erim232.xsb
 ####
 #  #
##  ####
# $    ##
#  $  $ #
# $ ##* #
##  #.* #
 ####..+#
    #####
Title: erim232-fourth collection
Author: Erim SEVER from TURKEY