;erim36.xsb
   #####
   #   #
  ## # ##
### $   #
#...$$# #
###@#   #
  #######
Title: erim36-first collection
Author: Erim SEVER from TURKEY

