;erim38.xsb
########
#...#  #
# .*   ##
##@$$$  #
 ### $  #
   #   ##
   ##  #
    ####
Title: erim38-first collection
Author: Erim SEVER from TURKEY

