;erim133.xsb
 #####
##   ###
#  * $ #
# *$. @#
#  .####
#####
Title: erim133-second collection
Author: Erim SEVER from TURKEY

