;erim248.xsb
    #####
#####   #
#     . #
# #$##.##
# $@*..#
###$ $ #
  #    #
  ######
Title: erim248-fifth collection
Author: Erim SEVER from TURKEY