;erim244.xsb
    #####
#####   #
#    .$ #
# $##.$##
# $... #
### #$ #
  ##  @#
  ######
Title: erim244-fifth collection
Author: Erim SEVER from TURKEY