;erim09.xsb
  ######
  # $..#
###  *.#
#  $ *.#
# $$$#.#
#  # ###
#@   #
######
Title: erim09-first collection
Author: Erim SEVER from TURKEY

