;erim116.xsb
    #####
    #   #
#####  $####
# $ $ $....#
#....$ $ $ #
####$  #####
   #  @#
   #####
Title: erim116-second collection
Author: Erim SEVER from TURKEY

