;erim194.xsb
####
#  ###
#  . #
#*$$ #
#  .@#
######
Title: erim194-fourth collection
Author: Erim SEVER from TURKEY