;erim88.xsb
      ####
   ####  #
   #     #
####$  $ ###
# $  #.$#  #
#    *..#$ #
##   #+##  ##
 # $#...    #
 #  #$.#  $ #
 ###  ..$####
   # $   #
   #  ####
   ####
Title: erim88-second collection
Author: Erim SEVER from TURKEY

