;erim100.xsb
       ######
  ######    #
 ##   #  #$ #
 #  $   *#  ###
##$$.# @ * *  #
# *..# * * #  #
#   ## ## * * #
###$   .##    #
  #  * .#######
  #######
Title: erim100-second collection
Author: Erim SEVER from TURKEY

