;erim161.xsb
  ##############
  #  .....  $  #
  # $#####  $  #
  #. ### #..# ###
 ## #  # #### $ #
 #@ $ $###...   #
 ## #   .# $#$###
### #### #  # #
#    $    # $ #
# #.##### #   #
# ###   #  .# #
# ####### ### #
#  ##  $      #
##    $$$###  #
 ####    # ####
    ######
Title: erim161-second collection
Author: Erim SEVER from TURKEY

