;erim13.xsb
  ####
###  ######
#    #@   #
#  # $ $$ #
#   $    ##
##$## ####
 #  #$ #
 ##....#
  ###. #
    #. #
    ####
Title: erim13-first collection
Author: Erim SEVER from TURKEY

