;erim145.xsb
   ####
   #  ###
####    #
#    ** #
# *##   #
## .#* ##
 #  $ @#
 #  ####
 ####
Title: erim145-second collection
Author: Erim SEVER from TURKEY

