;erim89.xsb
    ######
  ###    #
 ## $. $ #
## $ .$ ##
# $. * ##
#  .$.##
##$.$.#
 # .$.##
 ##. $ #
  ##  @#
   #####
Title: erim89-second collection
Author: Erim SEVER from TURKEY

