;erim69.xsb
   ####
   #  #
 ###  #
## $.$###
#  .*.  #
#  $.$  #
###  ####
  #@ #
  ####
Title: erim69-second collection
Author: Erim SEVER from TURKEY

