;erim267.xsb
    #####
#####   #
#   ..$ #
# $ ##$##
#  ..  #
###*#$ #
  #@.$ #
  ######
Title: erim267-fifth collection
Author: Erim SEVER from TURKEY