;erim21.xsb
  #####
  #   #
  # # #######
  #         #
### #### #  #
#   ### ## ##
# # * ###+$#
#  $* #    #
###    .* ##
  ### ## ##
    #    #
    ######
Title: erim21-first collection
Author: Erim SEVER from TURKEY

