;erim75.xsb
 ####
 #  #
##  ######
#  *#@*  #
#    **  #
##  #  ###
 ####  #
    ####
Title: erim75-StartWithEndPosition-second collection
Author: Erim SEVER from TURKEY

