;erim62.xsb
#######
#  #  #
#  #  #
# $$$ #
# @...#
#######
Title: erim62-second collection
Author: Erim SEVER from TURKEY

