;erim91.xsb
#####
#   ##
# $  ###
# $$.*.#
# .$*.*#
##..$$.#
 #*..$$##
 #    $ #
 ####  @#
    #####
Title: erim91-second collection
Author: Erim SEVER from TURKEY

