;erim98.xsb
 #####
##   #
# .$.#####
# $+$    #
##.$. $  #
 #########
Title: erim98-second collection
Author: Erim SEVER from TURKEY

