;erim210.xsb
#######
#  #  #
#  #  #
#.**$@#
#. $ ##
###  #
  #  #
  ####
Title: erim210-fourth collection
Author: Erim SEVER from TURKEY