;erim227.xsb
    ##
   #  #
   # $ #
  # .$  ##
 #  .#..  #
# $$# #$$ #
#  ..#.. #
 ##  $ ##
   # $ #
    # @#
     ##
Title: erim227-fourth collection
Author: Erim SEVER from TURKEY