;erim47.xsb
   ####
####  #
#@   $#
#  #. ##
## .#  #
 #$    #
 #  ####
 ####
Title: erim47-second collection
Author: Erim SEVER from TURKEY

