;erim72.xsb
 ######
 #... #
 #.$$ #
##$ # ##
#  #   #
#  $   #
#@  ####
#####
Title: erim72-second collection
Author: Erim SEVER from TURKEY

