;erim95.xsb
######
#    #
# $. ##
##$.$ #
 # . @#
 ######
Title: erim95-second collection
Author: Erim SEVER from TURKEY

