;erim127.xsb
#####
#   #
#$$ ##
#..*@#
######
Title: erim127-ForKids-second collection
Author: Erim SEVER from TURKEY

