;erim20new.xsb
#######
#     ##
# .*$$ #
# * #@ #
# .*  ##
#     #
#######
Title: erim20new-first collection
Author: Erim SEVER from TURKEY

