;erim152.xsb
######
#  ..#
# $ .###
### $$ #
  #   @#
  ######
Title: erim152-second collection
Author: Erim SEVER from TURKEY

