;erim97.xsb
 #####
##   #
# .$.###
# $@$  #
# .$.  #
########
Title: erim97-second collection
Author: Erim SEVER from TURKEY

