;erim122.xsb
   #####
  ##   ##
 ##  .  ##
## *$*$* ##
#  . . .  #
# **$*$*$ #
#  . . .  #
## *$ $* ##
 ##  *  ##
  ##  @##
   #####
Title: erim122-second collection
Author: Erim SEVER from TURKEY

