;erim184.xsb
 #########
 #  . .  #
 # $ $ $ #
##..#$#..##
#.$$. .$$.#
##.$$$$$.##
 ##.$+$.##
  #######
Title: erim184-third collection
Author: Erim SEVER from TURKEY