;erim173.xsb
    #####
    #   #
  ### $ ##
 ##  $ $ #
 #  # $  #
## ### ###
# . #   #
#.+.  $ #
# . #####
#####
Title: erim173-second collection
Author: Erim SEVER from TURKEY

