;erim224.xsb
  #######
  #     #
 ## **  #
 #    ###
 # # * #
 # * # #
###    #
# $*.###
#   @#
######
Title: erim224-fourth collection
Author: Erim SEVER from TURKEY