;erim57.xsb
    #####
  ###   #
  #  $  #
 ## $ # #
## $  # #
# $  ##.#
#   ##.*#
# $##...#
#      ##
##### @#
    ####
Title: erim57-second collection
Author: Erim SEVER from TURKEY

