;erim170.xsb
   ####
   #  #
   #  ##
#### * #
#    * #
# *    #
# * *###
###*  #
 #@*  #
 ######
Title: erim170-StartWithEndPosition-second collection
Author: Erim SEVER from TURKEY

