;erim163.xsb
   ###
  ##.##
 ## $ ##
## @ $ ##
# $.#  .#
#.  *.$ #
## $   ##
 ## $ ##
  ##.##
   ###
Title: erim163-second collection
Author: Erim SEVER from TURKEY

