;erim79.xsb
     ####
    ##  #
#####   #
#     * #
#  **** ##
##  *@*  ##
 ## ****  #
  # *     #
  #   #####
  #  ##
  ####
Title: erim79-StartWithEndPosition-second collection
Author: Erim SEVER from TURKEY

