;erim243.xsb
    #####
#####   #
# .   * #
# # #$*##
#   *  #
### #$.#
  #   @#
  ######
Title: erim243-fifth collection
Author: Erim SEVER from TURKEY