;erim59.xsb
 #####
 #   #
##$. #
# ** #
# $. #
# ** #
#   @#
######
Title: erim59-second collection
Author: Erim SEVER from TURKEY

