;erim107.xsb
#######
#     #
# $ # #
# .*  #
#  $#*#
#* .*@#
#######
Title: erim107-ForKids-second collection
Author: Erim SEVER from TURKEY

