;erim268.xsb
    #####
#####  @#
# $ **$ #
#  * * ##
# . *  #
###. * #
  #    #
  ######
Title: erim268-fifth collection
Author: Erim SEVER from TURKEY