;erim67.xsb
  ####
### .#
#@   ##
# $$..#
# $ $.#
##  ###
 ####
Title: erim67-second collection
Author: Erim SEVER from TURKEY

