;erim11.xsb
  #####
 ##   ####
 # $   $ #
 #. $$#$@#
##.##  $ #
# *.#   ##
# ... ###
#######
Title: erim11-first collection
Author: Erim SEVER from TURKEY

