;erim240.xsb
    #####
#####   #
#   .$  #
# ##$. ##
#  ..$$#
### $. #
  #  #@#
  ######
Title: erim240-fifth collection
Author: Erim SEVER from TURKEY