;erim223.xsb
    ####
    #  #
    #$ #
#####  #
# $ **.##
#   #.  #
###    @#
  #######
Title: erim223-fourth collection
Author: Erim SEVER from TURKEY