;erim256.xsb
    #####
#####   #
#     * #
# $#.#.##
# $ *  #
### * *#
  #   @#
  ######
Title: erim256-fifth collection
Author: Erim SEVER from TURKEY