;erim253.xsb
    #####
#####   #
# ....  #
# $$.* ##
#   ## #
###$ $$#
  #   @#
  ######
Title: erim253-fifth collection
Author: Erim SEVER from TURKEY