;erim102.xsb
########
#      #
# $**. #
# * ** #
# *  * #
# *  * #
# .**$ #
#     @#
########
Title: erim102-second collection
Author: Erim SEVER from TURKEY

