;erim209.xsb
 ####
 #  ##
##   ###
#  $   #
# $.*  #
## #.###
 #$#.#
 #  @#
 #####
Title: erim209-fourth collection
Author: Erim SEVER from TURKEY