;erim167.xsb
      #######
      # .   #
    ### #   #
    #   ..###
    #   #.##
    ## ##..#
  ####. #. #
###   $$$. #
# $ $$   #.#
# $    $$$@#
#   ##   ###
##########
Title: erim167-second collection
Author: Erim SEVER from TURKEY

