;erim41.xsb
######
#....#
#.$*$###
#@* $  #
### $  #
  #  $ #
  ##   #
   #####
Title: erim41-first collection
Author: Erim SEVER from TURKEY

