;erim176.xsb
 #############
##@.   .   . ##
#*$*$*$*$*$*$ #
#.   .   .    #
###*###$###$#.#
#.   .   .    #
#*$*$*$.$*$*$ #
## .   .   .  #
 ##############
Title: erim176-second collection
Author: Erim SEVER from TURKEY

