;erim221.xsb
 ########
 #      #
 # $.$. #
 ## #* ##
 #  #  #
## ## ##
# .$ * #
#     @#
########
Title: erim221-fourth collection
Author: Erim SEVER from TURKEY