;erim50.xsb
   ####
  ##  #
###   ##
#  $.$ ##
#  .#.  #
###$.$  #
  #   ###
  #@ ##
  ####
Title: erim50-second collection
Author: Erim SEVER from TURKEY

