;erim49.xsb
  ####
  #  #
###  #
#  $$##
# . . #
###  @#
  #####
Title: erim49-second collection
Author: Erim SEVER from TURKEY

