;erim70.xsb
   ####
####  #
# $  $#
#   ..###
##..*   #
 #$  $  #
 # @#####
 ####
Title: erim70new-second collection
Author: Erim SEVER from TURKEY

