;erim77.xsb
    #######
    #     #
    #* $ $#####
  ###  $ $    ####
  #. # ##*$$$@   #
###.$# #.$ $ ##$ #
# $        *.# *.#
#.  #  #  $     ##
#.  .#######$. $#
#.. .#     #... #
######     ######
Title: erim77-second collection
Author: Erim SEVER from TURKEY

